R 600 500
NO ../path_to_the_north_texture
SO ../path_to_the_south_texture
EA ../path_to_the_east_texture
WE ../path_to_the_west_texture
S ../path_to_the_sprite_texture

F 254,100,0
C 225,30,0

11111
10001
100N111
11111