R 600 1200
NO textures/eagle.xpm
SO textures/purplestone.xpm
EA textures/greystone.xpm
WE textures/redbrick.xpm
S  textures/de05.xpm
F textures/wood.xpm
C 140,40,0
11111111111
100000S0011
10000000111
10000000111
10000000111
10000000111
10000000111
11111111111