R 1600 900
NO textures/eagle.xpm
SO textures/purplestone.xpm
EA textures/greystone.xpm
WE  textures/redbrick.xpm
S  textures/de05.xpm

F textures/wood.xpm
C 142,42,2
11111111111111111111111111111111111111111111111111111111111111
10000000000000000000000000000000000000000000000000000000010001
10000000000000000000000000000000000000000000000000000000000001
10000000000000000000000000000000000000000000000000000000010001
10001111111110111111111100011111111111111111111101111111111111
10001111111100011111111110111111111111111111110000011111111111
10001111111100011110000000000000111111111111110000011111111111
10001111111111111110000000000000111111111111111111111111111111
10001111111111111110000000000000111111111110000000000001000001
10001111111111111110000000000000111111111110000000000001000001
10000000000000000010000000000000100000000110000000000001000001
10000000000000000000000000000000000000000000000000000000000111
10000000000000000010000000000000100000000110000000000001111111
10001111111111111110000000000000111111111110000000000001111111
10001111111111111110000000000000111111111110000000000001111111
10001111111111111110000000000000111111111111111110111111111111
10001111111111111110000000000000111111111111111000001111111111
10001111111111111111111111111111111111111111111000001111111111
11011111111111111111111111111111111111111111111000001111111111
10001111111111111111111111111111111111111111111000001111111111
10000111111111111111111111111111111111111111111000000000000011
10000111111111111111111111111111111111111111111000000000000011
10000111111111111111111111111111111111111111111000000000000011
10001111111111111111111111111111111111111111111000001111100011
11011111111111111111111111111111111111111111111111111111100011
11111111111111111111111100000001111111111111111111111111100011
11111111111111111111111100000001111111111111111111111111100011
11111111111111111111111100000001111111111111111111111111100011
11111111111111111111111100000001111111111111111111111111100011
11000011111111111111111100000001111111100001111111111111110111
11000010010000111111111100000001111111100001111111111111110111
11000010010000111111111100000000111111111101111111111110000001
11000011011101111111111100000000111111111101111111111110000001
11000000000000100000000100000000000000000000000000000010000001
110000000000000000000000000N0000100000000000000000000000000001
11000000000000100000000100000001100000000000000000000010000001
11000011011101111111111100000001111111111101111111111110000001
11000010010000111111111100000001111111111111111111111110000001
11000010010000111111111100000001111111111111111111111111111011
11000011111111111111111100000001111111111111111111111111110001
11000011111111111111111100000001111111111111111111111111110001
11111111111111111111111111000111111111111111111111111111111111
11111111111111111111111111101111111111111111111111111111111111
11111111111111111111111111000111111111111111111111111111111111
11111111111111111111111110000111111111111111111111111111111111
11111111111111100000000000000111111111111111111111111111111111
11111111111111100011111110000111111111111111111111111111111111
11111111111111110111111111000111111111111111111111111111111111
11111111111111100011111111000111111111111111111111111111111111
11111111111111100001111111000111111111111111111111111111111111
11111111111111100011111111100111111111111111111111111111111111
11111111111111000001111100000000011111111111111111111111111111
11111111111111100011111000000000011111111111111111111111111111
11111111111111000001111100000000011111111111111111111111111111
11111111111111100011111000000000011111111111111111111111111111
11111111111111000001111100000000011111111111111111111111111111
11111111111111100011111111111111111111111111111111111111111111
11111111111111111111111111111111111111111111111111111111111111