R 640 360
NO textures/redbrick.xpm
SO textures/wood.xpm
EA textures/redbrick.xpm
WE textures/wood.xpm
S  textures/wood.xpm


F 30,250,50
C 30,30,250

111111111
110000001
100100001
100001001
1N0011011
111111111