R 600 600
NO textures/eagle.xpm
SO textures/purplestone.xpm
EA textures/greystone.xpm
WE textures/redbrick.xpm
S  textures/wood.xpm

F 42,42,42
C 30,100,250

111111111
110000001
100100001
100001001
1N0011011
111111111