R 1400 850
NO textures/eagle.xpm
SO textures/purplestone.xpm
EA textures/greystone.xpm
WE  textures/redbrick.xpm
S  textures/de05.xpm

F textures/wood.xpm
C 142,42,2

11111111111111111111111
 1000200E00200000000021
 1000100001111001111011
 101100201   110100001
 100011001   101100111
1100000000111100002011
 1111010000000011111111
 111111111111111111111