R 800 800
NO textures/eagle.xpm
SO textures/purplestone.xpm
EA textures/greystone.xpm
WE  textures/redbrick.xpm
S   textures/barrel.xpm

F textures/redbrick.xpm
C textures/wood.xpm

 1111 11111111111111111
 1200100001000000000001
 100010000101100111101
 100000000100110100001
 10001102011010110111
110000000011010000001
 11110011010000111111
 1000201N000011
 11111111111111111111