R 450 900
NO textures/eagle.xpm
SO textures/purplestone.xpm
EA textures/greystone.xpm
WE  textures/redbrick.xpm
S   textures/barrel.xpm

F textures/greystone.xpm
C textures/wood.xpm

 1111 11111
 1200100001
 1000100001
 1000000001
 10001102011
11000000001
 1111000001
 1000000N21
 1111111111