R 800 800
NO textures/eagle.xpm
SO textures/purplestone.xpm
EA textures/greystone.xpm
WE  textures/redbrick.xpm
S   textures/de05.xpm

F textures/redbrick.xpm
C textures/wood.xpm

 1111 111111111111111111
 12001000010000000000021
 1000100001011001111011
 100000000100110100001
 100011020110101101111
11000000201101000N001
 1111001001000011111
 100020100000111
 11111111111111111111