R 400 300
NO ../path_to_the_north_texture
SO ../path_to_the_south_texture
EA ../path_to_the_east_texture
WE ../path_to_the_west_texture
S ../path_to_the_sprite_texture

F 254,100,0
C 225,30,0

1111111
1100001
1001001
1000001
1N00011
1111111