R 1400 850
NO textures/eagle.xpm
SO textures/purplestone.xpm
EA textures/greystone.xpm
WE  textures/redbrick.xpm
S  textures/de05.xpm
F 150,140,90
C 150,40,90
11111111111111111111111
 1000200E002000000000021
 1000100001111001111011
 101100201   110100001
 100011001   101100111
1100000000111100002011
 1111010000000011111101
 111111111111111111111