R 800 800
NO textures/eagle.xpm
SO textures/purplestone.xpm
EA textures/greystone.xpm
WE  textures/redbrick.xpm
S   textures/de05.xpm

F textures/redbrick.xpm
C textures/wood.xpm

 11111111111111111111111
 12001000010000000000021
 1010100E01111001111011
 100100001   110100001
 100011021   101121111
110000002011110000001
 1111001001000011111
 11111111111111111111