R 600 600
NO textures/eagle.xpm
SO textures/purplestone.xpm
EA textures/greystone.xpm
WE  textures/redbrick.xpm
S   textures/barrel.xpm

F 42,42,42
C 30,100,250


 1111111111
 1200000001
 1000000001
 1000010001
 10000102011
11000000001
 1000000001
 1000000N21
 1111111111