R 800 800
NO textures/eagle.xpm
SO textures/purplestone.xpm
EA textures/greystone.xpm
WE  textures/redbrick.xpm
S   textures/de05.xpm

F textures/wood.xpm
C 150,40,90

 11111111111111111111111
 12000000000000000000021
 1000100E01111001111011
 101100001   110100001
 100011021   101120111
110000002011110000001
 1111010000000011111
 11111111111111111111