R 1000 1000
NO textures/eagle.xpm
SO textures/purplestone.xpm
EA textures/greystone.xpm
EA  textures/redbrick.xpm
F   textures/de05.xpm
S textures/wood.xpm
C 150,40,90

 11111111111111111111111
 10000000000000000000001
 1000100E01111001111011
 101100001   110100001
 100011001   101100111
1100000000111100000011
 1111010000000011111101
 111111111111111111111